level 4
next_level assets/level_3.map
next_level assets/level_5.map
map
# # L # # # # # -1
# 0 K 0 # 0 . D -1
# 0 0 0 # 0 0 # -1
# . 0 0 # 0 S # -1
# 0 0 0 # 0 0 # -1
# 0 0 M 0 . 0 # -1
# # # # # # # # -2