level 2
next_level assets/level_3.map
map
# # D # # -1
# C 0 0 # -1
# 0 G 0 # -1
# 0 S 0 # -1
# # # # # -2