level 5
next_level assets/level_4.map
next_level assets/level_1.map
map
# # # # # # D # -1
# 0 K 0 . # 0 # -1
# 0 0 0 0 # 0 # -1
# . S 0 0 # . # -1
# 0 # # # # 0 # -1
# 0 0 . 0 0 G L -1
# # # # # # # # -2