level 10

map
# # # A # # # # -1
# 0 0 0 O 0 T # -1
# 0 T 0 0 0 0 # -1
# 0 0 0 0 0 S # -1
# 0 T 0 0 0 0 # -1
# 0 0 0 T 0 T # -1
# # # # # # # # -2