level 10

map
# # # # # # # # -1
# 0 0 0 M 0 T # -1
# 0 T 0 0 0 0 # -1
# 0 0 0 0 0 S # -1
# 0 T 0 0 0 0 # -1
# 0 0 0 T 0 T # -1
# # # # # # # # -2